0000000000000000000000000000000000000000000000000000000000000000
0000000000000000000000000000000000000000000000000000000000000000
0000000000000000000000000000000000000000000000000000000000000000
0000000000000000000000000000000000000000000000000000000000000000
0000000000000000000000000000000000000000000000000000000000000000
0000000000000000000000000000000000000000000000000000000000000000
1111111110000000000000000000000000000000000001111111111111000000
1111111110000000000000000000000000|00r000|0000111111111111000000
1111111110000000000000000000000000011111100000111111111111000000
1111111110000000000000000000000000000000000001111111111111000000
1111111111111110000000000000000000000000000000111111111111000000
10000000000000101110000000000000001000r0000r00111111111111000000
100000000000001000000000|000r0|000111111111111111111111111000000
1000000000000000000000000111110000111111111111111111111111000000
1000000000000000000000000000000000111111111111111111111111000000
1000000000000000000000000000000001111111111111111111111111000000
1000000000000000000000000000000000111111111111111111111111000000
100000000000001000000r0000000r0000111111111111111111111111000000
1111100000011111111111111111111111111111111111111111111111000000
0000010000110000000000000000000000000000000000000000000000000000
0000000000000000000000000000000000000000000000000000000000000000
0000000000000000000000000000000000000000000000000000000000000000
0000000000000000000000000000000000000000000000000000000000000000
0000000000000000000000000000000000000000000000000000000000000000
0000000000000000000000000000000000000000000000000000000000000000
0000000000000000000000000000000000000000000000000000000000000000
0000000000000000000000000000000000000000000000000000000000000000
0000000000000000000000000000000000000000000000000000000000000000
0000000000000000000000000000000000000000000000000000000000000000
00000000b0000000000000000000000000000000000000000000000000000000
0000000010000000000000000000000000000000000000000000000000000000
0000000000000000000000001000000100000000000000000000000000000000
0000000000000000000000000000000000000000000000000000000000000000
0000000000000000000000000000000000000000000000000000000000000000
00000000000000000000000000000000000000000b0000000000000000000000
000000000000b000000000000000000000000000010000000000000000000000
00000000000011000000111000111100011110000000000000000b0000001110
0000000000000100000011100011010001001000000000000000010000000000
00000000000001000000111sss1101sss1001000000000000000000000000000
ssssssssssssss1sssss111111110111110010000000000b0000000000000000
00000000000000000000000000000000000010000000000100000000000000l0
00000000000000010000000000000000000010000000000000000000000000l1
0000000000000001000000000000000000001000000000000000000000b000l1
00000000000000010000000000000000000011111111111111111111111111l1
00000000000000010000000000000000000000000000000000000000000000l1
00000000000000010000000000000000000000000000000000000000000000l1
00000000000000010000000000000000000000000000000000000000000000l1
00000000000000010000000000000000000000000000000000000000000000l1
00000000000000010000000000000000000000000000000000000000000000l1
00000000000000010000000000000000000000000000000000000000000000l1
00000000000000010000000000000000000000000000000000000000000000l1
00000000000000010000000000000000000000000000000000000000000000l1
00000000000000011111111100000000000000000000000000000000000000l1
0000000000000000000000000110000000000011100110001100011011111111
0000000000111111111000000000001100000000100000000000000010000000
0000000000100000000000000000000000110000100000000000000010000000
0000000000100000000000000000000000000000100000000000000010000000
0000000000100000000000000000000000000000100000000000000010000000
00000000001000000000001111111111111111111sssssssssssss0010000000
0000000000100000000110100000000000000000111111111111110010000000
0000000000000000110000100000000000000000100000000000000010000000
0000000000000000000000100000000000000000100000000000000010000000
1111111111111111111111100000000000000000100000000000000b10000000
1111111111000000000000000000000000000000111111111111111110000000
