0000000000000000000000000000000000000000000000000000000000000000
0000000000000000000000000000000000000000000000000000000000000000
0000000000000000000000000000000000000000000000000000000000000000
0000000000000000000000000000000000000000000000000000000000000000
0000000000000000000000000000000000000000000000000000000000000000
000000000000000000000000000000000000000000000000000d000000000000
1111111110000000000000000000000000000000000001111111111111000000
1111111110000000000000000000000000|00r000|0000111111111111000000
1111111110000000000000000000000000011111100000111111111111000000
11111111100t0000000000000000000000000000000001111111111111000000
1111111111111110000000000000000000000000000000111111111111000000
10000000000000101110000000000000001000r0000r00111111111111000000
100000000000001000000000|000r0|000111111111111111111111111000000
1000000000000000000000000111110000111111111111111111111111000000
1000000000000000000000000000000000111111111111111111111111000000
1000000000000000000000000000000001111111111111111111111111000000
1000000000000000000000000000000000111111111111111111111111000000
100000000000001000000r0000000r0000111111111111111111111111000000
1111100000011111111111111111111111111111111111111111111111000000
0000010000110000000000000000000000000000000000000000000000000000
00000000c0000000000000000000000000000000000000000000000000000000
00000000c0000000000000000000000000000000000000000000000000000000
00000000c0000000000000000000000000000000000000000000000000000000
00000000c0000000000000000000000000000000000000000000000000000000
00000000c0000000000000000000000000000000000000000000000000000000
00000000c0000000000000000000000000000000000000000000000000000000
0000000000000000000000000000000000000000000000000000000000000000
0000000000000000000000000000000000000000000000000000000000000000
0000000000000000000000000000000000000000000000000000000000000000
00000000b000000000000000v000000v00000000000000000000000000000000
0000000010000000000000000000000000000000000000000000000000000000
0000000000000000000000001c000c010000c000000000000000000000000000
00000000000c0000000000000000000000000000000000000000000000000000
0000000000000000000000000000000000000000000000000000000000000000
00000000000000000000000000000000000000000b0000000000000000000000
000000000000b00000000c0000cccc0000000000010000000000000000000t00
000000000000110000001110001111000111100000000000c0000b0000001110
0000000000000100000011100011010001001000000000000000010000000000
00000000000001000000111sss1101sss100100000000000000000000cc00000
ssssssssssssss1sssss111111110111110010000000000b0000000000c00000
0000000000000000000000000000000000001000000000010000000000c000l0
00000000000000010000000000000000000010000000000000000000000000l1
0000000000000001000000000000000000001000000000000000000000b000l1
00000000000000010000000000000000000011111111111111111111111111l1
00000000000000010000000000000000000000000000000000000000000000l1
00000000000000010000000000000000000000000000000000000000000000l1
00000000000000010000000000000000000000000000000000000000000000l1
00000000000000010000000000000000000000000000000000000000000000l1
00000000000000010000000000000000000000000000000000000000000000l1
00000000000000010000000000000000000000000000000000000000000000l1
00000000000000010000000000000000000000000000000000000000000000l1
00000000000000010t00000v00000000000000000000c0000c0000c0000000l1
00000000000000011111111100c00000000000000000000000000000000000l1
0000000000000000000000000110000c00000011100110001100011011111111
0000000000111111111000000000001100000000100000000000000010000000
0000000000100000000000000000000000110000100000000000000c10000000
0000000000100000000000000000000000000000100000000000000010000000
0000000000100000000000000000000000000000100000000000000010000000
00000000001l00000000001111111111111111111sssssssssssss0010000000
00000000001l0000000110100000000000000000111111111111110010000000
000p0000000l0000110000100000000000000000100000000000000010000000
d0000000000l0000000ccc100000000000000000100000000000000010000000
111111111111111111111110000000000000000010*00000ccc0000b10000000
1111111111000000000000000000000000000000111111111111111110000000
