0000000000000000000000000000000000000000000000000000000000000011
0000000000000000000000000000000000000000000000000011000000001111
0000000000000000000000000000000000000000000000000011010100010101
0000000000000000000000000000000000000000000000000011111111111111
0000000000000000000000000000000000000000000000000001111111111111
0000000000000000000000000000000000000000000000000000000000011111
0000000000000000000000000000000000000000000000000000000000001111
0000000000000000000000000000000000000000000000000000000000000111
0000000000000000000000000000000000000000000000000000000000000011
0000000000000000000000000000000000000000000000000000000000000001
0000000000000000000000000000000000000000000000000000000000000000
0000000000000000000000000000000000000000000000000000000000000000
0000000000000000000000000000000000000000000000000000000000000000
00000000000000000000000000000000000000000000000000000000000000000
0000000000000000000000000000000000000000000111111100011111100000
0000000000000000000000000000000000000000000111111100001111100000
000000000000000000000000000000000000000000000011110001111l100000
0000000000000000000000000000000000000000000000111000011111100000
0000000000000000000000000000000000000000000000111100011111100000
0000000000000000000000000000000000000000001111111111111111100000
0000000000000000000000000000000000000000001111000111111111100000
0000000000000000000000000000000000000000001111000111110000000000
0000000000000000000000000000000000000000001111000111110000000000
0000000000000000000000000000010101010100001111000111110000011111
0000000000000000000000000000111111111100000000000111110000011111
0000000000000000000000000001111111000100000000000111110000011111
0000000000000000000000000010101010001100000000100101110000001111
0000000000000000000000000111111111111111111111111111111111111111
0000000000000000000000000111111111111111111111111111111111101111
0000000000000000000000000111111111111111111111111111111111111111
0000000000000000000000000111111111111110000000000000111111111111
0000000000000000000000000111111111111110000000000000011111101111
0000000000000000000000000111111111111110000000000000000000001111
0000000000000000000000000111111111111110000000000000000000001111
00000000000000000000000001111111111111100000000000000o0000001l11
0000000000000000000000000000111111100000000000000000011111111111
0000000000000000000000000000111111100000000000000000001111111111
0000000000000000000000000000111111100000000000000000000000001111
0000000000000000000000000000111111100000000000000000000000001111
0000000000000000000000000000111111100000000000000000000000001111
0000000000000000000000000000111111100000000000000000000000001111
0000000000000000000000000000111111100000000000000000011111111111
0000000000000000000000000000111111100000000000000000001111111111
0000000000000000000000000000111111100000000000000000000000001111
0000000000000000000000000000111111100000000000000000000000001111
0000000000000000000000000000111111100000000000000000000000001111
0000000000000000000000000000111111100000000000000000000000011111
0000000000000000000000000000111111100000000000000000000000011111
0000000000000000000000000000111111100000000000000000000000011111
0000000000000000000000000000111111100000000000000000000000011111
0000000000000000000000000000111111100000000000000000000000011111
0000000000000000000000000000111111100000000000000000000000011111
0000000000000000000000000000111111100000000000000000000000011111
0000000000000000000000000000111111100000000000000000000000011111
0000000000000000000000000000111111100000000000000000000000000000
0000000000000000000000000000111111100000000000000000000000000000
0000000000000000000000000000111111100000000000000000000000000000
0000000000000000000000000000111111100000000000000000000000000000
0000000000000000000000000000111111100000000000000000000000000000
0000000000000000000000000000111111100000000000000000000000000000
0000000000000000000000000000111111100000000000000000000000000000
0000000000000000000000000000111111100000000000000000000000000000
0000000000000000000000000000111111100000000000000000000000000000
0000000000000000000000000000111111100000000000000000000000000000
