001111111111111111110000000000000000000000000000000000000000000001
001000000000000000000000000000000000000001110000000000000000000001
001000000000000000000000000000000000000000000000000000000000000001
001000000000000000000000000000000000000000000000000000000000000001
001000000000000000000000000000000000000000000000000000000000000001
001000000000000000000000111000000011100000000000000000000000000001
001000000000000000000001000000001000000000000000000000000000000001
001000000000000000000000000000000000000000000000000000000000000001
001000000000000000000000000000000000000000000000000000000000000001
001111111111111111110000111000000001100000001110000000000000000001
000000000000000000000000000000000000000000000000000000000000000001
000000000000000000000000000000000000000000000000000000000000000001
001111000000000000000000000000000000000000000000000000000000000001
000011100000000000000000000000000000000000000000000000000000000001
001011100000000000000000000000000000000000000000000000000000000001
001111110000000000000000000000000000000000000000000000000000000001
001111110000000000000000000000000000000000000000000000000011111111
001111110000000000000000000000000000000000000000000000000000000000
001111110000000000000000000000000000000000000000000000000000000000
001111111110011111111111111111111110111111111111011111011111111111
111111111111111111111111001111111101111111111111011111111110011111
001110000111000000000000000000000000000000000000001110000000011100
001110000111000000000000000000000000000000000000001110000000011100
001110111111000000000000000000000000000000000000001110000000010100
001110000111000000000000000000000000000000000000001100000000011100
001110000111000000000000000000000000000000000000001110000000011100
001110000111000000000000000000000000000000000000001110000000010100
001110000111000000000000000000000000000000000000001110000000011100
001110000111000000000000000000000000000000000000001010000000011100
001110000111000000000000000000000000000000000000001110000000011100
001110000111000000000000000000000000000000000000001110000000011100
001110000111000000000000000000000000000000000000000110000000011000
001110000111000000000000000000000000000000000000001110000000011100
001110000111000000000000000000000000000000000000001110000000011000
001110000111000000000000000000000000000000000000001110000000011100
001110000111000000000000000000000000000000000000001100000000011000
001110000111000000000000000000000000000000000000001110000000011100
001110000111000000000000000000000000000000000000001010000000001100
001110000111000000000000000000000000000000000000001110000000011100
001110000111000000000000000000000000000000000000001100000000010100
001111111111000000000000000000000000000000000000001110000000011100
001110000111000000000000000000000000000000000000001100000000011100
001110000111000000000000000000000000000000000000001110000000010100
001110000111000000000000000000000000000000000000001110000000011100
001111111111000000000000000000000000000000000000001010000000011100
001111111111000000000000000000000000000000000000000110000000001100
001111111111000001000000001000000000000000000000001110000000011100
001110000111000001111111111110111100000000000000001110000000011100
001110000111000000000000000001111111110100000000001100000000011000
001110000111000000000000000000010111111111100000001110000000011100
001110000111000000000000000000000000000111111111111110000000011100
001110000111000000000000000000000000000011111100111111001100010100
001111111111111100000000000000000000000000111110111111101110011100
001111111111111100000000000000000000000000000000000011111111111100
000111111111011100000000000000000000000000000000000000000111111100
000011111110001100000000000000000000000000000000000000000001111100
000011111111011100000000000000000000000000000000000000000000111110
001111111111111000000000000000000000000000000000000000000000000110
001111111111110000000000000000000000000000000000000000000000000110
001011111111111000000000000000000000000000000000000000000000000110
000011111111111100000000000000000000000000000000011111111111111010
000011111111111100000000000000000000000000000000011111111111111110
00111111111111d+00000000000000000000000000000000011111111111111110
001111111111111111111111111111111111111111111111111111111111111000
