1111111111111111110000000000000000000000t00000000000000000000001
1000000000000000000000000000000000000001110000000000000000000001
1000000000000000000000000000000000000000000000000000000000000001
1000000000000000000000000000000000000000000000000000000000000001
1000000000000000000000000000000000000^00000000000000000000000001
1000000000000000000000111000000011100000000000000000000000000001
100000p000000000000001000000001000000000000000000000000000000001
1000000000000000000000000000000000000000000c00000000000000000001
1000000000000000000000000000^0000000000000000000000000000000c001
111111111111111111000011100000000110000000111000^000^000^000c001
00000000000000000000000000000000000000000000000000000000000ccc01
000000000000000000sssssssssssssssssssssssssss00000000ssss000c001
111111000000000000000000000000000000000000000s00000ss00000000001
1000000000000000000000000000000000000000000000sssss0000000000001
1000000000000000000000000000000000000000000000000000000000000001
1000000000000000000000000000000000000000000000000000000000@00001
1000000000000000000000000000000000000000000000000000000011111111
1000000000000000000000000000000000000000000000000000000000000000
1*[0000000000000000000000000000000000000000000000___0000s0000000
1111l0000000000000000cvc00000000000000000000000000000000s0000000
0000l000000000000000c000c00000000000000000000000sssssssss0000000
0000l00000000000000c00000c0000000000000000000000s000000000000000
0000l000000000000000000000c00000000000000___0000s000000000000000
000011111000000b0000000000c000000000000000000000s000000000000000
00000000000000000000000000c000000000000000000000s000000000000000
ssssssssssssssss000c0000000000000000000ssssssssss000000000000000
000000000000000000000000000000000000000s000000000000000000000000
000000000000000000000000000b00000___000s000000000000000000000000
0000000000000000000c0000000000000000000s000000000000000000000000
0000000000000000000000000000000000ssssss000000000000000000000000
0000000000000000000000000000000000000000000000000000000000000000
00000000000000000c0000000000000000000000000000000000000000000000
0000000000000000000000000000000000000000000000000000000000000000
0000000000000000000000000000000000000000000000000000000000000000
00000000000000000c0000000000000000000000000000000000000000000000
0000000000000000000000000000000000000000000000000000000000000000
0000000000000000000000000000000000000000000000000000000000000000
0000000000000000000000000000000000000000000000000000000000000000
0000000000000000000000c00000000000000000000000000000000000000000
000t000000000000000000000000000000000000000000000000000000000000
0101110000000000000000c00000000000000000000000000000000000000000
0000000000000000000000000000000000000000000000000000000000000000
0000000000000000000c00000000000000000000000000000000000000000000
0000000000000000000c00000000000000000000000000000000000000000000
0000000000000000000c00000000000000000000000000000000000000000000
00b0000000000000000000000000000000000000000000000000000000000000
0011110000000001000000001000000000000000000000000000000000000000
000000000__00001111111111000000000000000000000000000000000000000
00000000000000000000000000011100000[0000000000000000000000000000
0ssssssssssssss00000000s00000000011111000000]0000000000000000000
000000000000000000000000s000000000000000001111100000000000000000
0000000000000000000000000s0000000000000000000000000[0]]000000000
11111111111111000000000000sssss000000000000000000001111110000000
111111111111110000000000000000s000000000000000000000000000000000
1111111111111100000000000000000ssss00000000000000000000000000000
11111111111111000000000000000000000ssssssssssssssss00000000^^^00
1111111111111100000000000000000000000000000000000000000000000000
1111111111111100000000000000000000000000000000000000000000000000
1111111111111100000000000000000000000000000000000000000000000000
1111111111111100000000000000000000000000000000000000000000000000
1111111111111100000000000000000000000000000000010000000000001000
1111111111111100000000000000000000000000000000010000000000001000
111111111111d-0000000000000000000000000000+000010000000000001000
1111111111111111111111111111111111111111111111111111111111111000
