0101111111110011111100000000000000000000000000000000000000000000
0001111111111001111100000000000000000000111100000000000000000000
0111111101111110111100000000000000000000111000000000000000000000
0011111001111111111000000000000000000001110000000000000000000000
0001111011111111110000000000000000000111110000000000000000000000
0111111111111111111000001111000011111111110000000000000000000000
0111111111111111111100011100000111111111111111100000000000000000
0011111111111111111111111000111100011100001111100000000000000000
0001111111111111111100000001111000011100000011100000000000000000
0000101111111111111100001111110000011100000011100000000000000000
0000000000011100000000000011100000000100000001100000000000000000
0000000000011100000000000011100000011100000011000000000000000000
0011110000011100000000000001100000011100000011000000000000000000
0000111000011000000000000011100000011100000011100000000000000000
0010111000011000000000000001100000010100000010100000000000000000
0011111100011100000000000011100000010100000010100000000000000000
0011111100011100000000000011100000011100000011100000000000111111
0011111100001100000000000011100000011100000001100000000000000000
0011111100001100000000000011100000011100000011100000000000000000
0011111111111111111111111111111111101111111111110111110111111111
1111111111111111111111110011111111011111111111110111111111100111
0011100001110000000000000000000000000000000000000011100000000111
0011100001110000000000000000000000000000000000000011100000000111
0011101111110000000000000000000000000000000000000011100000000101
0011100001110000000000000000000000000000000000000011000000000111
0011100001110000000000000000000000000000000000000011100000000111
0011100001110000000000000000000000000000000000000011100000000101
0011100001110000000000000000000000000000000000000011100000000111
0011100001110000000000000000000000000000000000000010100000000111
0011100001110000000000000000000000000000000000000011100000000111
0011100001110000000000000000000000000000000000000011100000000111
0011100001110000000000000000000000000000000000000001100000000110
0011100001110000000000000000000000000000000000000011100000000111
0011100001110000000000000000000000000000000000000011100000000110
0011100001110000000000000000000000000000000000000011100000000111
0011100001110000000000000000000000000000000000000011000000000110
0011100001110000000000000000000000000000000000000011100000000111
0011100001110000000000000000000000000000000000000010100000000011
0011100001110000000000000000000000000000000000000011100000000111
0011100001110000000000000000000000000000000000000011000000000101
0011111111110000000000000000000000000000000000000011100000000111
0011100001110000000000000000000000000000000000000011000000000111
0011100001110000000000000000000000000000000000000011100000000101
0011100001110000000000000000000000000000000000000011100000000111
0011111111110000000000000000000000000000000000000010100000000111
0011111111110000000000000000000000000000000000000001100000000011
0011111111110000010000000010000000000000000000000011100000000111
0011100001110000011111111111101111000000000000000011100000000111
0011100001110000000000000000011111111101000000000011000000000110
0011100001110000000000000000000101111111111000000011100000000111
0011100001110000000000000000000000000001111111111111100000000111
0011100001110000000000000000000000000000111111001111110011000101
0011111111111111000000000000000000000000001111101111111011100111
0011111111111111000000000000000000000000000000000000111111111111
0001111111110111000000000000000000000000000000000000000001111111
0000111111100011000000000000000000000000000000000000000000011111
0000111111110111000000000000000000000000000000000000000000001111
0011111111111110000000000000000000000000000000000000000000000001
0011111111111100000000000000000000000000000000000000000000000001
0010111111111110000000000000000000000000000000000000000000000001
0000111111111111000000000000000000000000000000011111111111111110
0000111111111111000000000000000000000000000000011111111111111111
0011111111111111000000000000000000000000000000011111111111111111
0011111111111111111111111111111111111111111111111111111111111110
