0000000000000000000000000000000000000000000000000000000000000002
0000000000000000000000000000000000000000000000000000000000000002
0000000000000000000000000000000000000000000l00000000000000000002
0000000000000000000000000000000000000000000l2222220000000.000002
000000000000000000000000000000000000000i000l00000022222222222222
0000000000000000000000000000000000000000000llllll000000000000000
000000000000000000000000000000000000000000000000l000000000000000
0000000000000000000000000000000000000000000i0000l000000000000000
000000000000000000000000000000000000000000000000l000000000000000
0000000000000000000000000000000000000000000llllll000000000000000
0000000000000000000000000000000000000000000l00000000000000000000
0000000000000000000000000000000000000000000l0000i000000000000000
0000000000000000000000000000000000000000i00l00000000000000000000
0000000000000000000000000000000000000000000l00000000000000000000
000000000000000000000000000000000000000000020or20000000000000000
0000000000000000000000000000000000000000000022222000000000000000
0000000000000000000000000000000000000000000000022200000000000000
0000000000000000000000000000000000000000000000000000000000000000
0000000000000000000000000000000000222222200000000000002220000000
0000000000000000000000000000000000000000000000022220000000000000
0000000000000000000000000000000000000000000c00200000000000000000
000000000000000000000000000s0000000s0000000200000000c00000000000
00000000000000000000000000s000000000s0000002000000002000000ss000
0000000000000000000000f00s000c0t0c00000000022000000020000ss20ll2
00000000000000000000000000002222222222000000000000222sssss020ll2
00000000000000000000000000000000000000000000000000000s0000022ll2
0000000000000000000000000000000p0000020000000020ssssss0000002ll2
000000000000000000000000000000000000020000000020s000000000002ll2
000000000000000000000000000000000000000000022220s000000000002l22
0000000000000000000000000000000000000c0000000000s000000000000ll2
000000000000000000000000022222222222222ssssssssss000000000002ll2
00000000000000000000000002222222222222200000000000000002000020l2
0000000000000000000000000222222222222220000000000000000000002ll2
0000000000000000000000000222222222222220000000000000000000002ll2
00000000000000000000000002222222222222200000000000000o0000002ll2
0000000000000000000000000000000000000000000000000000000000000ll2
0000000000000000000000000000000000000000000000000000000000002ll2
0000000000000000000000000000000000000000000000000000000000002ll2
0000000000000000000000000000000000000000000000000000000000002ll0
0000000000000000000000000000000000000000000000000000000000002ll2
0000000000000000000000000000000000000000000000000000000000000ll2
000000000000000000000000000000000000000000000000000002t000000ll2
0000000000000000000000000000000000000000000000000000002222222ff2
0000000000000000000000000000000000000000000000000000000000002002
0000000000000000000000000000000000000000000000000000000000002002
0000000000000000000000000000000000000000000000000000000000002002
00000000000000000000000000000000000000000000000000000200t0022002
0000000000000000000000000000000000000000000000000000002222222002
0000000000000000000000000000000000000000000000000000000000022002
0000000000000000000000000000000000000000000000222220000000022002
0000000000000000000000000000000000000000000000000002000000000002
0000000000000000000000000000000000000000000000000000222000000002
0000000000000000000000000000000000000000000000000000000200a000b2
0000000000000000000000000000000000000000000000000000000022222222
0000000000000000000000000000000000000000000000000000000000000000
0000000000000000000000000000000000000000000000000000000000000000
0000000000000000000000000000000000000000000000000000000000000000
0000000000000000000000000000000000000000000000000000000000000000
0000000000000000000000000000000000000000000000000000000000000000
0000000000000000000000000000000000000000000000000000000000000000
0000000000000000000000000000000000000000000000000000000000000000
0000000000000000000000000000000000000000000000000000000000000000
0000000000000000000000000000000000000000000000000000000000000000
0000000000000000000000000000000000000000000000000000000000000000
