1111111111111111110000000000000000000000000000000000000000000001
1000000000000000000000000000000000000001110000000000000000000001
1000000000000000000000000000000000000000000000000000000000000001
1000000000000000000000000000000000000000000000000000000000000001
1000000000000000000000000000000000000^00000000000000000000000001
1000000000000000000000111000000011100000000000000000000000000001
1000000000000000000001000000001000000000000000000000000000000001
1000000000000000000000000000000000000000000000000000000000000001
1000000000000000000000000000^00000000000000000000000000000000001
111111111111111111000011100000000110000000111000^000^000^0000001
0000000000000000000000000000000000000000000000000000000000000001
000000000000000000sssssssssssssssssssssssssss00000000ssss0000001
111111000000000000000000000000000000000000000s00000ss00000000001
1000000000000000000000000000000000000000000000sssss0000000000001
1000000000000000000000000000000000000000000000000000000000000001
1000000000000000000000000000000000000000000000000000000000000001
1000000000000000000000000000000000000000000000000000000011111111
1000000000000000000000000000000000000000000000000000000000000000
10[0000000000000000000000000000000000000000000000___0000s0000000
1111000000000000000000v000000000000000000000000000000000s0000000
000000000000000000000000000000000000000000000000sssssssss0000000
000000000000000000000000000000000000000000000000s000000000000000
00000000000000000000000000000000000000000___0000s000000000000000
000011111000000b00000000000000000000000000000000s000000000000000
000000000000000000000000000000000000000000000000s000000000000000
ssssssssssssssss00000000000000000000000ssssssssss000000000000000
000000000000000000000000000000000000000s000000000000000000000000
000000000000000000000000000b00000___000s000000000000000000000000
000000000000000000000000000000000000000s000000000000000000000000
0000000000000000000000000000000000ssssss000000000000000000000000
0000000000000000000000000000000000000000000000000000000000000000
0000000000000000000000000000000000000000000000000000000000000000
0000000000000000000000000000000000000000000000000000000000000000
0000000000000000000000000000000000000000000000000000000000000000
0000000000000000000000000000000000000000000000000000000000000000
0000000000000000000000000000000000000000000000000000000000000000
0000000000000000000000000000000000000000000000000000000000000000
0000000000000000000000000000000000000000000000000000000000000000
0000000000000000000000000000000000000000000000000000000000000000
0000000000000000000000000000000000000000000000000000000000000000
0101110000000000000000000000000000000000000000000000000000000000
0000000000000000000000000000000000000000000000000000000000000000
0000000000000000000000000000000000000000000000000000000000000000
0000000000000000000000000000000000000000000000000000000000000000
0000000000000000000000000000000000000000000000000000000000000000
00b0000000000000000000000000000000000000000000000000000000000000
0011110000000001000000001000000000000000000000000000000000000000
000000000__00001111111111000000000000000000000000000000000000000
00000000000000000000000000011100000[0000000000000000000000000000
0ssssssssssssss00000000s00000000011111000000]0000000000000000000
000000000000000000000000s000000000000000001111100000000000000000
0000000000000000000000000s0000000000000000000000000[0]]000000000
11111111111111000000000000sssss000000000000000000001111110000000
111111111111110000000000000000s000000000000000000000000000000000
1111111111111100000000000000000ssss00000000000000000000000000000
11111111111111000000000000000000000ssssssssssssssss00000000^^^00
1111111111111100000000000000000000000000000000000000000000000000
1111111111111100000000000000000000000000000000000000000000000000
1111111111111100000000000000000000000000000000000000000000000000
1111111111111100000000000000000000000000000000000000000000000000
1111111111111100000000000000000000000000000000010000000000001000
1111111111111100000000000000000000000000000000010w00w00w00w01000
111111111111d+0000000000000000000000000-000000010000000000001000
1111111111111111111111111111111111111111111111111111111111111000
