0000000000000000000000000000000000000000000000000000000000000002
0000000000000000000000000000000000000000000000000000000000000002
0000000000000000000000000000000000000000000000000000000000000002
ä000000000000000000000000000000000000000000l2222220000000.000002
000000000000000000000000000000000000000i000l00000022222222222222
0000000000000000000000000000000000000000000llllll000000000000000
000000000000000000000000000000000000000000000000l000000000000000
0000000000000000000000000000000000000000000i0000l000000000000000
000000000000000000000000000000000000000000000000l000000000000000
0000000000000000000000000000000000000000000llllll000000000000000
0000000000000000000000000000000000000000000l00000000000000000000
0000000000000000000000000000000000000000000l0000i000000000000000
0000000000000000000000000000000000000000i00l00000000000000000000
0000000000000000000000000000000000000000000l000c0000000000000000
000000000000000000000000000000000000000000020or20000000000000000
00000000000000000000000000000000000000000000222220000000000000t0
0000000000000000000000000000000000000000000000022200000000000111
0000000000000000000000000000000000|00r00|0000000000000000000s000
00000000000000000000000000000000002222222000000000000022200s0000
0000000000000000000000000000000000000000000000022220000000s00000
0000000000000000000000000000000000000000000c00200000000000000000
000000000000000000000000000s000v000s0000000200000000c00000000000
00000000000000000000000000s000000000s0000002000000002000000s0000
0000000000000000000000f00s000cctcc0000000002200000<<20000s02bll2
00000000000000000000000000002222222222000000000000222sssss022ll2
0000000000000000000000000000000000000000000000c000000s0000022ll2
0000000000000000000000000000000p0000020000000020ssssss0000002ll2
0000000000000000000000000000000000000200000<<<20s000000000002ll2
000000000000000000000000000000000000000000022220s000000000002ll2
|0r0|0|0r0|0|0r0|0000000000000000000000000000000s000000000000ll2
022200022200022200022200022222222222222ssssssssss000000000002ll2
0000000000ss0000000000000222222222222220000000000000000000002ll2
000000020000s000000000v00222222222222220000000000000000000002ll2
0000000200000ssssssssfffs222222222222220000000000000000000002ll2
0000000000000000000000000222222222222220000000000000000000002ll2
c000000000000000000000000000000000000000000000000000000000002ll2
c002000000000000000000000000000000000000000000000000000000000ll2
t000000000000000000000000000000000000000000000000000|t0r00r0|ll2
u0sss00000000000000000000000000000000000000000000000011111110ll0
0s00000l22222222000000000000000000000000000000000000000000002ll2
00000i0l00000000000000000000000000000000000000000000000000000ll2
0000000l000000000000000000000000000000000000000000000|0c0c0c|ll2
0000000l0i000000000000000000000000000000000000000000002222222ff2
0000000l0000000cvc0000000000000000000000000000000000000000002002
00000i0l22200002220000000000000000000000000000000000000000002002
0000000l00000000000000000000000000000000000000000000000000002002
0000000l0i000000000000000000000000000000000000000000000000002002
sssss00l00ssssssssssss000000000000000000000000000000000000002002
0000000000000000000000000000000000000000000000v0000000000002002
0000000000000000000000000000000000000000000000222220000000002002
0l|00r000r0000|00000000000000000000000000000000000020c0000000002
0l22222222222220000000000000000000000000000000000000222000000002
0l2222222222222000000000000000000000000000000000000000020vбv00b2
0l00000000000000000000000000000000000000000000000000000022222222
0000000000000000000000000000000000000000000000000000000000000000
0000000000000000000000000000000000000000000000000000000000000000
000000.000000000000000y00000000000000000000000000000000000000000
2222222222222222222222200000000000000000000000000000000000000000
0000000000000000000000000000000000000000000000000000000000000000
0000000000000000000000000000000000000000000000000000000000000000
0000000000000000000000000000000000000000000000000000000000000000
0000000000000000000000000000000000000000000000000000000000000000
0000000000000000000000000000000000000000000000000000000000000000
0000000000000000000000000000000000000000000000000000000000000000
