0000000000000000000000000000000000000000000000000000000000000011
0000000000000000000000000000000000000000000000000011000000001111
0000000000000000000000000000000000000000000000000011010100010101
0000000000000000000000000000000000000000000000000011111111111111
0000000000000000000000000000000000000000000000000001111111111111
0000000000000000000000000000000000000000000000000000000000011111
0000000000000000000000000000000000000000000000000000000000001111
0000000000000000000000000000000000000000000000000000000000000111
0000000000000000000000000000000000000000000000000000000000000011
0000000000000000000000000000000000000000000000000000000000000001
0000000000000000000000000000000000000000000000000000000000000000
0000000000000000000000000000000000000000000000000000000000000000
0000000000000000000000000000000000000000000000000000000000000000
0000000000000000000000000000000000000000000000000000000000000000
0000000000000000000000000000000000000000000111111100011111100000
0000000000000000000000000000000000000000000111111100001111100000
0000000000000000000000000000000000000000000000111100011111100000
0000000000000000000000000000000000000000000000111000011111100000
0000000000000000000000000000000000000000000000111100011111100000
0000000000000000000000000000000000000000001111111111111111100000
0000000000000000000000000000000000000000001111000111111111100000
0000000000000000000000000000000000000000001111000111110000000000
0000000000000000000000000000000000000000001111000111110000000000
0000000000000000000000000000010101010100001111000111110000011111
0000000000000000000000000000111111111100000000000111110000011111
0000000000000000000000000001111111000100000000000111110000011111
0000000000000000000000000010101010001100000000100101110000001111
0011101111101110111100000011111111111111111111111111111111111111
0111100111101111111110000111111111111111111111111111111111101111
1111111111111111111111001111111111111111111101111111111111111111
0111111111111111111111111111111111111110000000000000111111111111
0000000000000000000000000100111111111110000000000000011111101111
0000000000000000000000000001111111111100000000000000000000001111
0000000000000000000000000111111111111010000000000000000000001111
0000000000000000000000000111111111100010000000000000000000001111
0000000000000000000000000000111111100000000000000000000000001111
0000000000000000000000000000111111100000000000000000000000001111
0000000000000000000000000000111111100000000000000000011111111111
0000000000000000000000000000110011100000000000000000011111111111
0000000000000000000000000000110011100000000000000000000000001111
0000000000000000000000000000110011100000000000000000000000001111
0000000000000000000000000000111111100000000000000000011111111111
0000000000000000000000000000111111100000000000000000001111111111
0000000000000000000000000000111111100000000000000000000000001111
0000000000000000000000000000111110000000000000000000000000001111
0000000000000000000000000000111111100000000000000000000000001111
0000000000000000000000000000111111100000000000000000000000011111
0001111111111000000000000000111111100000000000000000000000011111
0001111111111000000000000000001111100000000000000000000000011111
0001111111111000000000000000100111100000000000000000000000011111
0001111111111000000000000000111111100000000000000000000000011111
0000000000000000000000000000111111100000000000000000000000011111
0000000000000000000000000000111111100000000000000000000000011111
0000000000000000000000000000111101100000000000000000000000011111
0000000000000000000000000000111101100000000000000000000000000000
0000000000000000000000000000111101100000000000000000000000000000
0000000000000000000000000000111111100000000000000000000000000000
0011111111111000000000000000011111100000000000000000000000000000
0011111111111000000000000000001111100000000000000000000000000000
0011111111111000000000000000011111100000000000000000000000000000
0011111111111111111100000000111111100000000000000000000000000000
0011111111111111111100000000111111100000000000000000000000000000
0000110011001100011000000000111111100000000000000000000000000000
0000110011001100010000000000111111100000000000000000000000000000
