0000000000000000000000000000000000000000000000000000000000000002
0000000000000000000000000000000000000001000000000000000000000002
0000000000000000000000000000000000000001100000000000000000000002
0000000000000000000000000000000000000000000022222200000000000002
0000000000000000000000000000000000000000000000000022222222222222
0000000000000000000000000000000000000000000000000000000000000000
0000000000000000000000000000000000000000000000000000000000000000
0000000000000000000000000000000000000000000000000000000000000000
0000000000000000000000000000000000000000000000000000000000000000
0000000000000000000000000000000000000000000000000000000000000000
0000000000000000000000000000000000000000000000000000000000000000
0000000000000000000000000000000000000000000000000000000000000000
0000000000000000000000000000000000000000000000000000000000000000
0000000000000000000000000000000000000000000000000000000000000000
0000000000000000000000000000000000000000000000000000000000000000
0000000000000000000000000000000000000000002222000000000000000000
0000000000000000000000000000000000000000000000020000000000000000
0000000000000000000000000000000000|00r00|00000000000000000000000
0000000000000000000000000000000000222222200000000000002220000000
0000000000000000000000000000000000000000000000022220000000000000
0000000000000000000000000000000000000000000c00200000000000000000
000000000000000000000000000s000v000s0000000200000000c00000000000
00000000000000000000000000s000000000s000000200000000200000000000
0000000000000000000000f00s000cc0cc0000000002200000<<20000s02b002
00000000000000000000000000002222222222000000000000222sssss022002
0000000000000000000000000000000000000000000000c000000s0000022002
000000000000000000000000000000000000020000000020ssssss0000002002
0000000000000000000000000000000000000200000<<<20s000000000002002
000000000000000000000000000000000000000000022220s000000000002002
|0r0|0|0r0|0|000|0000000000000000000000000000000s000000000000002
022200022200022200022200022222222222222ssssssssss000000000002002
0000000000ss0000000000000222222222222220000000000000000000002002
000000020000s000000000v00222222222222220000000000000000000002002
0000000200000ssssssssfffs222222222222220000000000000000000002002
0000000000000000000000000222222222222220000000000000000000002002
0000000000000000000000000000000000000000000000000000000000002002
0002000000000000000000000000000000000000000000000000000000000002
0000000000000000000000000000000000000000000000000000|00r00r0|002
00sss00000000000000000000000000000000000000000000000022222220000
0s00000022222222000000000000000000000000000000000000000000002002
0000000000000000000000000000000000000000000000000000000000000002
00000000000000000000000000000000000000000000000000000|0c0c0c|002
0000000000000000000000000000000000000000000000000000002222222ff2
000000000000000cvc0000000000000000000000000000000000000000002002
0000000022200002220000000000000000000000000000000000000000002002
0000000000000000000000000000000000000000000000000000000000002002
0000000000000000000000000000000000000000000000000000000000002002
sssss00000ssssssssssss000000000000000000000000000000000000002002
0000000000000000000000000000000000000000000000v00000000000002002
0000000000000000000000000000000000000000000000222220000000002002
00|00r000r0000|00000000000000000000000000000000000020c0000000002
0022222222222220000000000000000000000000000000000000222000000002
00222222222222200000000000000000000000000000000000000002000000b2
0000000000000000000000000000000000000000000000000000000022222222
0000000000000000000000000000000000000000000000000000000000000002
0000000000000000000000000000000000000000000000000000000000000002
0000000000000000000000y00000000000000000000000000000000000000002
2222222222222222222222200000000000000000000000000000000000000002
0000000000000000000000000000000000000000000000000000000000000002
0000000000000000000000000000000000000000000000000000000000000002
0000000000000000000000000000000000000000000000000000000000000002
0000000000000000000000000000000000000000000000000000000000000002
0000000000000000000000000000000000000000000000000000000000000002
0000000000000000000000000000000000000000000000000000000000000002
