0000000000000000000000000000000000000000000000000000000000000000
0000000000000000000000000000000000000000000000000000000000000000
0000000000000000000000000000000000000000000000000000000000000000
0000000000000000000000000000000000000000000000000000000000000000
0000000000000000000000000000000000000000000000000000000000000000
000000000000000000000000000000000000000000000000000d000000000000
1111110000000000000000000000000000000000000001111001111111000000
1111111100000000000000000000000000000000000000111101111111000000
1111111100000000000000000000000000011111100000111111111110000000
1111111110000000000000000000000000000000000001111111111100000000
1111111111111110000000000000000000000000000000111111111110000000
1000100011000110111000000000000000100000000000111111111111000000
1001100011000110000000000000000000000011111111111111111111000000
1001100011000110000000000111110000000111111111111111111111000000
1001100011000110000000000000000000001111111111111111111111000000
1001100011000110000000000000000001111111111111110011111000000000
1001100010000110000000000000000000111100011111110011111111000000
1001100011000110000000000000000000111110011111111111111111000000
1111111111111111111111111111111111111111011111111011111100000000
0000011111111111111111111111111111111111011111110011111111000000
0000001110000000000000000111000000000000000011100000000011000000
0000001101000000000000000110000000000000000011100000000011000000
0000001111000000000000000111000000000000000011000000000011000000
0000000111000000000000000011000000000000000011100000000011000000
0000000011000000000000000111000000000000000000100000000010000000
0000001111000000000000000111000000000000000001100000000011000000
0000001111000000000000000101000000000000000001100000000011000000
0000001010000000000000000111000000000000000011000000000001000000
0000001011000000111011111111111111110000000011100000000011000000
0000001111000001111111111111111111111100000011100000000011000000
0000001111000011110000000000000000001110000011000000000011000000
0000001101000011010000001000000100001110000011100000000010000000
0000001101000011100000000000000000001111000011000000000011000000
0000001111000011100000000000000000001111000011100000000011000000
0000001111000011100000000000000000001111001111100011110111100000
000000111100b011100000000000000000001111011111101111110111110000
0000001011001111000011100011110001100111111111111111111111111001
0000000011000111100011100011010001110111111111111111111111111101
0000001111000111100011111111011111111111111100011111110011111110
1111111111111111111111111111011111111111111101111111100111111111
1111111111111111111111111111111111111111111111111111111111111110
1111110011111111111111111111111111111111111111111111111111011111
1111100111111111111111011111001111110001100111111111111110011111
1111100111111111111110001110001111111111110111111111111111111111
0011100000000011000000000000001100000000000000000011111111110011
0011100000000011000000000000011100000000000000000111111111111011
0011100000000011000000000000011100000000000000000011111111110011
0011100000000011000000000000011100000000000000000011111111110011
0001100000000011000000000000011000000000000000001111111011000011
0011100000000011110001111111111001111110011111101111111011100011
0010100000000011111011111111111011111111011111110111111011100011
0011100000000011111111111111111111111111111111111111111111110011
0011100000000011111111111111111111111111111111111111111111111111
0010100000000011111111111111111111111111111111101111111111111111
0011100000111111111111111111111111111111111111001111111110000000
0011100000001111111111111111111111111111111111011111111110000000
0001100000100111111111111111111111111111111111111111111110000000
0011100000101111111111111100111111111111111111111111111110000000
0011100000001111111111111000011111111111111111000111111110000000
0011000000100000011111100000000000000000111111101111111111000000
0011100000111100011111000000000000000000111111111111111110000000
d011100000111110111110000000000000000000111111111111111110000000
1011111100111011111111000000000000000000111111111111111110000000
1111111110110001111111100000000000000000111111111111111110000000
