00000000000000000000000000000000
00000000000000000000000000000000
00000000000000000000000000000000
00000000000000000000000000000000
00000000000000000000000000000000
00000000000000000000000000000000
00000000000000000000000000000000
00000000000000000000000000000000
00000000000000000000000000000000
000p0000000000000000000000000000
00000000000000000000000000000000
00000000000000000000000000000000
00000000000000000000000000000000
00000000000000000000000000000000
00000000000000000000000000000000
00000000000000000000000000000000
00000000000000000000000000000000
00000000000000000000000000000000
00000000000000000000000000000000
00000000000000000000000000000000
00000000000000000000000000000000
00000000000000000000000000000000
000000000000v0000000000000000000
000000000000c00c0000000000000000
000000000111111100v0000000000000
0000000000cccc010000000000000000
00000000011111110000000000000000
10000000000000010000000000000000
10001000000000010000000000000000
100110000000f0010101010110010101
11111111111111111111111111111111
11111111111111111111111111111111
