0000000000000000000000000000000000000000000000000000000000000002
0000000000000000000000000000000000000002v0i000000000000000000002
0000000000000000000000000000000000000002200000000000000000000002
0000000000000000000000000000000000000000000l222222000000000.0002
00000000000000000000000000000000000000000i0l00000022222222222222
0000000000000000000000000000000000000000000l00000000000000000000
00000000000000000000000000000000000000000i0l0i000000000000000000
0000000000000000000000000000000000000000000l00000000000000000000
00000000000000000000000000000000000000000i0l00000000000000000000
0000000000000000000000000000000000000000000l0i000000000000000000
0000000000000000000000000000000000000000000l00000000000000000000
0000000000000000000000000000000000000000000l00000000000000000000
0000000000000000000000000000000000000000000l00000000000000000000
0000000000000000000000000000000000000000000l000c0000000000000000
000000000000000000000000000000000000000000cccc000000000000000000
0000000000000000000000000000000000000000002222000000000000000000
0000000000000000000000000000000000000000000000000220000000000000
0000000000000000000000000000000000|00r00|00000000000000000000000
0000000000000000000000000000000000222222200000000000002220000000
0000000000000000000000000000000000000000000000022220000000000000
0000000000000000000000000000000000000000000c00200000000000000000
000000000000000000000000000s000v000s0000000200000000c00000000000
00000000000000000000000000s000000000s000000200000000200000000000
0000000000000000000000f00s000cctcc0000000002200000<<20000s02bll2
00000000000000000000000000002222222222000000000000222sssss022ll2
0000000000000000000000000000000000000000000000c000000s0000022ll2
0000000000000000000000000000000p0002020000000020ssssss0000002ll2
0000000000000000000000000000000000022200000<<<20s000000000002ll2
000000000000000000000000000000000000000000022220s000000000002ll2
|0r0|0|0r0|0|000|0000000000000000000000000000000s000000000000ll2
c22200022200022200022200022222222222222ssssssssss000000000002ll2
c000000000ss0000000000000222222222222220000000000000000000002ll2
c00000020000s000000000v00222222222222220000000000000000000002ll2
c000000200000ssssssssfffs222222222222220000000000000000000002ll2
c000000000000000000000000222222222222220000000000000000000002ll2
c000000000000000000000000000000000000000000000000000000000002ll2
c002000000000000000000000000000000000000000000000000000000000ll2
t000000000000000000000000000000000000000000000000000|t0r00r0|ll2
u0sss00000000000000000000000000000000000000000000000022222220ll0
0s00000l22222222000000000000000000000000000000000000000000002ll2
00000i0l00000000000000000000000000000000000000000000000000000ll2
0000000l000000000000000000000000000000000000000000000|0c0c0c|ll2
0000000l0i000000000000000000000000000000000000000000002222222ff2
0000000l0000000cvc0000000000000000000000000000000000000000002002
00000i0l22200002220000000000000000000000000000000000000000002002
0000000l00000000000000000000000000000000000000000000000000002002
0000000l00000000000000000000000000000000000000000000000000002002
sssss00l00ssssssssssss000000000000000000000000000000000000002002
0000000000000000000000000000000000000000000000v00000000000002002
0000000000000000000000000000000000000000000000222220000000002002
00|00r000r0000|00000000000000000000000000000000000020c0000000002
0022222222222220000000000000000000000000000000000000222000000002
002222222222222000000000000000000000000000000000000000020v*v00b2
0000000000000000000000000000000000000000000000000000000022222222
0000000000000000000000000000000000000000000000000000000000000002
0000000000000000000000000000000000000000000000000000000000000002
000000.000000000000000y00000000000000000000000000000000000000002
2222222222222222222222200000000000000000000000000000000000000002
0000000000000000000000000000000000000000000000000000000000000002
0000000000000000000000000000000000000000000000000000000000000002
0000000000000000000000000000000000000000000000000000000000000002
0000000000000000000000000000000000000000000000000000000000000002
0000000000000000000000000000000000000000000000000000000000000002
0000000000000000000000000000000000000000000000000000000000000002
